1111111111111111111
1010000001000100011
100P0100C0001C000E1
1111111111111111111
