11111111111111111111
100000000000000000E1
10000000000000000001
10000000000000000001
10000000000000000001
10000000000C00000001
10000000000000000001
10000000000000000001
100P0000000000000001
10000000000000000001
11111111111111111111