11111111111111
10000100E00001
10010101111001
10010101100001
10P10101C10001
10010001101001
11111111111111