11111111111111
10000101E10001
10010101111001
10010101000001
10P10100C00001
10010001001001
11111111111111